3 3
X 1 1
0 0 1
1 0 1
5 6
1 X 1 1 0 1
0 0 1 1 0 1
0 1 1 1 0 1
0 0 0 1 0 1
1 1 0 0 0 1